%%%%%%
%.  P%
% %G%%
%    %
%%%%%%
