%%%%%%
%G   %
% %.%%
%P  .%
%%%%%%
